<HEADER>
frames 1
width 60
height 30
color white
slowdown 0
</HEADER>
<BODY>
############################################################
############################################################
###                                                      ###
###                                                      ###
###                                                      ###
###                                                      ###
###                                                      ###
###                                                      ###
###                                                      ###
###                                                      ###
###                                                      ###
###                                                      ###
############################                             ###
############################                             ###
###                                                      ###
###                                                      ###
###                                                      ###
###                                                      ###
###                                                      ###
###                                                      ###
###                                                      ###
###                                                      ###
############################################################
############################################################
###                                                      ###
###                                                      ###
###                                                      ###
###                                                      ###
############################################################
############################################################
end
</BODY>
<FOOTER>
version 1
</FOOTER>
