##################################################################################################
##################################################################################################
#########################################                                                       ##
#########################################                                                       ##
#########################################                                                       ##
#########################################   #####   #########################################   ##
#########################################   #   #   #   #########################         ###   ##
#########################################   #   #   #   #########################         ###   ##
#########################################   #   #   #   #########################         ###   ##
#########################################   #   #       #########################         ###   ##
#########################################   #   #       #######                           ###   ##
#########################################   #   #       #######                           ###   ##
#########################################   #   #####   #######                           ###   ##
#########################################   #   #   #   #######                           ###   ##
#########################################   #   #   #             ###########################   ##
#########################################   #   #   #             #                             ##
#########################################   #   #   #             #                             ##
#########################################   #   #       ####   ####                             ##
#########################################   #   #       ####   ####                             ##
################################                #       ####   ####                             ##
################################                ############   ####                             ##
################################                ############
################################   ######   ################
################################   ######   ################
################################   ######   ################