<HEADER>
frames 1
width 98
height 50
color white
slowdown 0
</HEADER>
<BODY>
##################################################################################################
##################################################################################################
#########################################                                                       ##
#########################################                                                       ##
#########################################                                                       ##
#########################################   #####   #########################################   ##
#########################################   #   #   #   #########################         ###   ##
#########################################   #   #   #   #########################         ###   ##
#########################################   #   #   #   #########################         ###   ##
#########################################   #   #       #########################         ###   ##
#########################################   #   #       #######                           ###   ##
#########################################   #   #       #######                           ###   ##
#########################################   #   #####   #######                           ###   ##
#########################################   #   #   #   #######                           ###   ##
#########################################   #   #   #             ###########################   ##
#########################################   #   #   #             #                             ##
#########################################   #   #   #             #                             ##
#########################################   #   #       ####   ####                             ##
#########################################   #   #       ####   ####                             ##
################################                #       ####   ####                             ##
################################                ############   ####                             ##
################################                ############      #                             ##
################################   ######   ################      #                             ##
################################   ######   ################      #                             ##
################################   ######   ################      #                             ##
##                          ####   ###                  ####      #                             ##
##                          ####   ###                  ####      #                             ##
##                          ####   ###                  ####      #                             ##
##   ##   ###############   ####   ###                  ####   ####                             ##
##   ##   #########         ####   ###                  ####   ####                             ##
##   ##   ##      #         ####   ###                  ####   ####                             ##
##   ##   ##      #         ####   ###                  ####   ##############################   ##
##   ##   ##      ##############   ###                  ####                              ###   ##
##   ##   ##                       ###                  ####                              ###   ##
##   ##   ##                       ###                  ####                              ###   ##
##   ##   ##                       ##########################################################   ##
##   ###########################   ##########################################################   ##
##   ##       ##################                                                                ##
##   ##       ##################                                                                ##
##   ##       ##################                                                                ##
##   ######   ##################   #################################   ###########################
##        #                        ################      ###########            ####            ##
##        #                        ################      ###########            ####            ##
##        #                        ################      ###########            ####            ##
##            ##################   ################      ###########   #############            ##
##            ############                               ###########                            ##
##            ############                               ###########                            ##
##########################                               ###########                            ##
##################################################################################################
##################################################################################################
end
</BODY>
<FOOTER>
version 1
</FOOTER>
